1111111111111111111
1000D00000000000011
1C00C00011011000001
1000100010001C00001
1111110010C01000001
1P000000101010000E1
1111111111111111111