1111111111
1C001000E1
1000CP0011
10D00C0001
1111111111