11111111111111111111
100CC00000E100000001
100000000C00000C0001
1000C000000C00000001
100D011111P000001111
11111111111111111111