11111111111
10C0100E001
111110000C1
1P000100001
11111111111