1111111111
10001000E1
1000000011
1P00000001
1111111111