1111111111
1C0010X0E1
1000C00011
1P000C0001
1111111111