11111111111
1000000E001
111110000C1
1PC00100001
11111111111