1111111111
1C001000E1
1000C00011
10000C0001
1111111111