111111111
101000001
1C0000001
10C000001
1C0011111
1P010E001
111111111