1111111111
1C001000E1
0000C00011
1P000C0001
1111111111