1111111111
1C001000E1
1000C00011
1P000C00E1
1111111111