1111111
1010001
1C00001
10C0001
1C00001
1P000E1
111111